BBBBBBBBBBBB
BBBBBBBBBBBB
BBBBBBBBBBBB
GGBBBBBBBBBB
GGGBBBBBBBBB
GGGGGGBBBBBB
GGGGGGGGBBBB
GGGGGGGGGGBB
G92
G92
G92
G92
est
137 500 4
